111111111111111111111111111111
100000000000000000000000000001
1000W0000000000000000000000001
100000000000000000000000000001
100000000000000000000000000001
1000000W000000000000W000W00001
100000000000000000000000000001
1000W000000000000000000000W001
100000000000000000000000000001
100000000000000WWWWW0000000001
100000W00000000000000000000001
100000000000W000W0000000000001
100000000000000000000000000001
100000000000000000000000000001
1000W00000000W00W000000000W001
100000000000000000000000000001
100000000000000000000000000001
1000000000W0000000000000000001
100000000000000000000000000001
100000000000000000000000000001
1000000000W00W0000000W00000001
100000000000000000000000000001
10000000000000000000000P000001
100000000000000000000000000001
1000000W0000W00000000W00000001
100000000000000000000000000001
1000000W00000W00000W0000000001
100000000000000000000000000001
100000000000000000000000000001
111111111111111111111111111111
