1111111111111111111111111111111111111111
1000000000000000000000000000000000000001
1000000000000000000000000000000000000001
1000000000000000000000000000000000000001
10000000WWWW00000000000000NNN00000000001
1000000000000000000000000000000000000001
1000000000000000000NNN000000WWWW00000001
1000000000000000000000000000000000000001
100S000000000000000000000000000000000001
100S00000000000000NNN0000000000000000001
100S000000000000000000000000000000000001
1000000000000000000000000000000000000001
1000000000000000000000000000000000000001
1000E000000000000000W0000P0000000N000001
1000E0000000000000000000000000000N000001
1000E0000000000000000000000000000N000001
1000E00000000000000000000000000000000001
1000000W00000000000000000000000000000001
1000000W00000000000000000000000000000001
1000000W00000000000000000000000000000001
1000000000000000000000000000000000000001
100000000E000000000000000000000NNN000001
100000000E000000000000000000000000000001
100000000E000000000WWWW00000000000000001
100000000E000000000000000000000000000001
1000000000000000000000000000000000000001
10000EEEEE00000000000000SSSSS00000000001
1000000000000000000000000000000000000001
1000000000000000000EEEE00000000000000001
1000000000000000000000000000000000000001
10000SSS00000000000000000000000000000001
1000000000000000000000000000000000000001
1000000000000000000000000000000000000001
100000000000000000SSS0000000000000000001
1000000000000000000000000000000000000001
1000000000000000000000000000000000000001
1000000000000000000000000000000000000001
1000000000000000000000000000000000000001
1000000000000000000000000000000000000001
1111111111111111111111111111111111111111
