1111111111111111111111111111111111111111
1000000000000000000000000000000000000001
1000000000000000000000000000000000000001
1000000000000000000000000000000000000001
1000000000000000000000000000000000000001
1000000000000000000000000000000000000001
1000000000000000000000000000000000000001
1000000000000000010000000010000000000001
1000000000000000000000000000000000000001
1000000000010000000001000000000000000001
1000000000000000100000000000100000000001
1000000000010000000000000000000000000001
1000000001000000000100000000000000000001
1000000000000100000000000P00000000000001
1000000000000000010000000000000100000001
1000000000110000000000000000000000000001
1000000000000000000010000000000000000001
1000000000000000000000100000000000000001
1000000000000000000000100000000000000001
1000000000000000000000000000000000000001
1000000000000000000000000000000000000001
1000000000000000000000000000000000000001
1000001000010010100000100100000000000001
1000000000000000000000100000000000000001
1000000000000000000001000000000000000001
1000000000000000000000000000000000000001
1000000000000000000000000000000000000001
1000101010101111000110101000000000000001
1000000000000000000000000000000000000001
1000000100000100001010000010000000000001
1000000000000000000000000000000000000001
1000000000010101010111100011010100000001
1000000000000000000000000000000000000001
1000000000000000000000000000000000000001
1000000000000000000000000000000000000001
1000000000000000000000000000000000000001
1000000000000000000000000000000000000001
1000000000000000000000000000000000000001
1000000000000000000000000000000000000001
1111111111111111111111111111111111111111
