1111111111111111111111111111111
1S00000000000000000000000000001
1011111111111111111111111111101
1010000000000000000000000000101
1010111111111111111111111100101
1010100000000000000000010100101
1010101111111111111111010100101
1010101000000000000001010100101
1010101011111111111101010100101
1010101010000000000101010100101
1010101010111111100101010100101
1010101010100000100101010100101
1010101010101110100101010100101
10101010101P1010100101010100101
1010101010101010100101010100101
1010101010101010100101010100101
1010101010101010100101010100101
1010101010101010100101010100101
1010101010101010100101010100101
1010101010101010100101010100101
1010101010101010100101010100101
1010100010101010100101000100101
1010111010101010100101111100101
1010000010100010100000000000101
1011111110111010111111111111101
10000000000000100000000000000E1
1111111111111111111111111111111
