NO assets/sprites/xpm/tofinish/walls/wallGore1.xpm
SO assets/sprites/xpm/tofinish/walls/wallGore1.xpm
WE assets/sprites/xpm/tofinish/walls/wallGore1.xpm
EA assets/sprites/xpm/tofinish/walls/wallGore1.xpm
F assets/sprites/xpm/tofinish/floors/stoneGore0.xpm
C assets/sprites/xpm/tofinish/ceilings/lampGore0.xpm
D assets/sprites/xpm/tiles/gates/doorGore0.xpm


     111111111111111           11111
     10000000001111          11000111
     111000011111001         100000001
     1000000000000011111    100000000011
11111111111000001111100111111000000000001
10000000011000001110000002101000000000011111
11112111111111011100000110000000000000000001
11112111111111011101000111111111111111111211
110000001101010111000001                101
100000000000000011000001111             101
100000000000000011010000001             101
110000011100010111110111111             101
1111211111121211111001                  101
1000000000000000000001                  101
1000000111010000000001111111111111111111121
10000010000010000000000000000000S0000000001
1111111100011111111111111111111111111111111
       11111
       11111
