11111111
10000001
10110001
10111011
111N0001
11111111